[
    {
        "id": 1,
        "name": "ORIGIN",
        "time": 30,
        "layout": [
            ["T","T","T","T","T","T","T","T","T","W","W","W","W","W","W","W","W","W","W","W"],
            ["T","T","T","T","T","T","T","T","T","W","W","W","W","W","W","W","W","W","W","W"],
            ["T","T","T","T","T","T","T","T","T","T","W","W","W","W","W","W","W","W","W","W"],
            ["T","T","T","T","T","T","T","T","T","T","T","T","T","T","T","T","T","T","T","T"],
            ["W","W","W","W","W","T","T","T","T","W","W","W","W","W","W","W","T","T","T","T"],
            ["W","W","W","W","W","W","T","T","T","W","W","W","W","W","W","W","T","T","T","T"],
            ["W","W","W","W","W","W","W","W","W","W","W","W","W","W","W","W","W","W","W","T"],
            ["W","W","W","W","W","W","W","W","W","W","W","W","W","W","W","W","W","W","W","T"],
            ["T","T","T","T","T","W","W","W","W","W","W","W","W","W","W","W","W","W","W","W"],
            ["T","T","T","T","T","W","W","W","W","W","W","W","W","W","W","W","W","W","W","W"],
            ["T","T","T","T","T","W","W","W","W","W","W","W","W","W","W","W","W","W","W","W"],
            ["T","T","T","T","T","T","T","T","W","W","W","W","W","W","W","W","W","W","W","W"]
        ],
        "player_start": [18, 3],
        "vortex_pos": [17, 4],
        "box_poses": [[6, 2], [7, 2]],
        "ice_x_poses": [[2, 1]],
        "box_x_poses": [[3, 1]]
    },

    {
        "id": 2,
        "name": "ORIGIN V2",
        "time": 30,
        "layout": [
            ["T","T","T","T","T","T","T","T","T","W","W","W","W","W","W","W","W","W","W","W"],
            ["T","T","T","T","T","T","T","T","T","W","W","W","W","W","W","W","W","W","W","W"],
            ["T","T","T","T","T","T","T","T","T","T","W","W","W","W","W","W","W","W","W","W"],
            ["T","T","T","T","T","T","T","T","T","T","T","T","T","T","T","T","T","T","T","T"],
            ["W","W","W","W","W","T","T","T","T","W","W","W","W","W","W","W","T","T","T","T"],
            ["W","W","W","W","W","W","T","T","T","W","W","W","W","W","W","W","T","T","T","T"],
            ["W","W","W","W","W","W","T","W","W","W","W","W","W","W","W","W","W","W","W","T"],
            ["W","W","W","W","W","T","W","W","W","W","W","W","W","W","W","W","W","W","W","T"],
            ["T","T","T","T","T","W","W","W","W","W","W","W","W","W","W","W","W","W","W","W"],
            ["T","T","T","T","T","W","W","W","W","W","W","W","W","W","W","W","W","W","W","W"],
            ["T","T","T","T","T","W","W","W","W","W","W","W","W","W","W","W","W","W","W","W"],
            ["T","T","T","T","T","T","T","T","W","W","W","W","W","W","W","W","W","W","W","W"]
        ],
        "player_start": [1, 1],
        "vortex_pos": [17, 4],
        "box_poses": [[6, 2], [7, 2]],
        "ice_x_poses": [[2, 1]],
        "box_x_poses": [[3, 1]]
    }
]